+---+---+---+---+---+---+---+---+---+---+---+---+---+---+---+---+
|       |       |           |           |   |   |   |   |   |   |
+   +---+   +   +   +---+   +   +   +   +   +   +   +   +   +   +
|           |       |       |   |   |                       |   |
+   +   +---+---+   +   +---+   +---+   +---+   +---+   +   +   +
|   |       |   |   |       |   |           |   |   |   |       |
+   +   +---+   +---+---+   +   +---+---+   +---+   +---+   +   +
|   |   |                   |           |               |   |   |
+   +   +---+   +---+---+   +---+---+   +---+---+---+   +   +   +
|   |   |               |                           |   |   |   |
+   +---+   +---+---+   +---+---+---+---+---+---+---+   +   +   +
|   |   |   |                           |   |   |   |   |   |   |
+   +   +   +---+   +---+---+---+---+---+   +   +   +   +   +   +
|   |   |   |   |                                       |   |   |
+   +   +   +   +---+---+---+---+---+   +   +   +   +   +   +   +
|   |   |       |   |       |       |   |   |   |   |   |   |   |
+   +   +---+   +   +   +   +   +   +---+---+---+   +   +   +   +
|       |   |       |   |   |       |               |   |   |   |
+   +   +   +---+   +   +   +---+   +   +---+---+---+   +   +   +
|   |   |       |               |                       |   |   |
+---+   +   +   +---+   +   +   +---+---+---+---+---+---+   +   +
|   |   |   |       |   |   |                           |   |   |
+   +   +   +   +   +---+   +---+   +---+---+   +---+   +   +   +
|   |       |   |   |   |       |           |           |   |   |
+   +   +   +---+   +   +---+   +---+   +---+---+   +---+   +   +
|   |   |   |   |           |       |                   |   |   |
+   +---+   +   +   +   +---+---+   +---+   +---+---+   +   +   +
|   |   |           |       |           |                   |   |
+   +   +   +   +   +   +   +   +---+   +---+---+---+---+---+   +
|       |   |   |   |   |   |                               |   |
+   +   +   +---+---+   +---+---+   +---+---+---+   +---+   +   +
|   |       |                               |                   |
+---+---+---+---+---+---+---+---+---+---+---+---+---+---+---+---+ 