+---+---+---+---+---+---+---+---+---+---+---+---+---+---+---+---+
|                                                               |
+   +---+   +   +---+---+   +---+---+---+---+---+   +---+   +   +
|   |       |   |       |               |       |   |       |   |
+   +   +---+   +---+   +---+---+---+   +   +   +---+   +---+   +
|   |       |   |                       |   |       |   |   |   |
+   +---+   +   +   +---+---+---+---+---+   +---+   +---+   +   +
|   |       |   |   |       |       |   |   |               |   |
+   +   +---+   +   +   +   +   +   +   +   +---+---+---+---+   +
|   |           |   |   |       |   |   |       |           |   |
+   +---+---+---+   +   +   +---+   +   +---+   +   +---+   +   +
|               |   |   |   |   |               |               |
+   +---+---+   +---+   +   +   +---+---+---+   +---+---+---+   +
|               |       |           |               |           |
+   +---+---+   +   +---+---+---+---+   +---+   +---+   +---+   +
|   |       |   |           |       |           |       |       |
+   +   +   +   +---+   +---+   +   +   +---+   +---+---+   +   +
|   |   |   |   |       |           |               |       |   |
+   +   +---+   +   +---+   +---+---+   +---+---+---+   +---+   +
|   |   |   |   |   |       |       |                   |       |
+   +   +   +   +   +   +---+   +   +---+---+---+   +---+   +---+
|   |       |   |   |   |       |   |   |   |       |   |       |
+   +---+   +   +   +   +   +---+   +   +   +   +---+   +---+   +
|       |   |   |   |   |   |       |   |   |       |   |       |
+   +   +   +   +   +   +   +   +---+   +   +---+   +   +   +---+
|   |   |   |   |   |   |   |           |       |       |       |
+   +   +   +   +   +   +   +   +---+---+---+   +   +   +---+   +
|   |   |       |       |   |   |               |   |   |       |
+   +   +---+---+---+---+---+   +   +---+---+---+---+   +   +---+
|   |                           |                   |   |       |
+   +---+---+---+   +---+---+   +---+---+---+   +---+---+---+   +
|   |                                                           |
+---+---+---+---+---+---+---+---+---+---+---+---+---+---+---+---+ 