+---+---+---+---+---+---+---+---+---+---+---+---+---+---+---+---+
|       |       |           |           |   |   |   |   |   |   |
+   +---+   +   +   +---+   +   +   +   +   +   +   +   +   +   +
|           |       |       |   |   |                       |   |
+   +   +---+---+   +   +---+   +---+   +---+   +---+   +   +   +
|   |       |   |   |       |   |           |   |   |   |       |
+   +   +---+   +---+---+   +   +---+---+   +---+   +---+   +   +
|   |   |                   |           |               |   |   |
+   +   +---+   +---+---+   +---+---+   +---+---+---+   +   +   +
|   |   |               |                           |   |   |   |
+   +---+   +---+---+   +---+---+---+---+---+---+---+   +   +   +
|   |   |   |                           |   |   |   |   |   |   |
+   +   +   +---+   +---+---+---+---+---+   +   +   +   +   +   +
|   |   |   |   |                                       |   |   |
+   +   +   +   +---+---+---+---+---+   +   +   +   +   +   +   +
|   |   |       |   |       |       |   |   |   |   |   |   |   |
+   +   +---+   +   +   +   +   +   +---+---+---+   +   +   +   +
|       |   |       |   |   |       |               |   |   |   |
+   +   +   +---+   +   +   +---+   +   +---+---+---+   +   +   +
|   |   |       |               |                       |   |   |
+---+   +   +   +---+   +   +   +---+---+---+---+---+---+   +   +
|   |   |   |       |   |   |                           |   |   |
+   +   +   +   +   +---+   +---+   +---+---+   +   +   +   +   +
|   |       |   |   |   |       |           |                   |
+   +   +   +---+   +   +---+   +---+   +---+   +   +   +   +   +
|   |   |   |   |           |       |                           |
+   +---+   +   +   +   +---+---+   +---+   +   +   +   +   +   +
|   |   |           |       |           |   |           |       |
+   +   +   +   +   +   +   +   +---+   +---+   +   +   +   +   +
|       |   |   |   |   |   |               |           |   |   |
+   +   +   +---+---+   +---+---+   +---+---+   +   +   +   +   +
|   |       |                               |               |   |
+---+---+---+---+---+---+---+---+---+---+---+---+---+---+---+---+ 
